20 31
1111111111111111111111111111111
1000010000000000000000000000001
1000010000000000000000000000001
1000010000000000000000000000001
1000010000000000000000000000001
1100000000001000000000000000001
1000000000001000000000000000001
1000000000001000000000000000001
1000000000001111000000000000001
1001110100001000000000000000001
1000000000001111000000000000001
1000000000001000000000000000001
1000000000001000000000000000001
1000000000001000000000000000001
1000000000000000000000000000001
1000000000001111111000000000001
1000000000000000000000000001001
1000000000000000000000010111001
1000000000000000000000010000001
1111111111111111111111111111111